00000000000000000000
00000000000000000000
00000000000000000000
00111110000001110000
00000000000000000000
00000000011111000000
00000000000000000000
00100190000000000000
01000111111000000000
11000000000000000000
11111111111111111111
