0000000000000000000000000000000000000000
0000000000000000000000000000000000000000
0080000000000008000000800000000000080000
0011111000000111000000111110000001110000
0000000000800000000000000000008000000000
0000000001111100000000000000011111000000
0000000000000000000000000000000000000000
0010019000000000000000100100000000000000
0100011111100000000001000111111000000000
1100000000000000080011000000000000000800
1111110000001111111111111100000000111111
0000111100000000000000000111100000000000
0000000000000000000000000000080000000000
0000000011110000000001110001111111100000
0000000000000000000000000000000000000000
0000000000000111111000000110000000000000
0000008000000000000000000080000000000000
0001111111000000000000111111100000000000
0000000000008000000000000000000000000000
1111111111111111111111111111111111111111